kills,hits,timePlayed,gamesPlayed,assists,misses,shots,deaths,winRate,playerSkill
21473,72010,1162,488,3259,213698,285708,9890,30.0,0.5295919976579470
25196,67430,2337,773,2897,206417,273847,13188,12.0,0.5017473071334720
12236,6559,2197,95,1122,25157,31716,6503,15.0,0.08004652526533930
18704,14715,3509,147,863,44293,59008,9969,32.0,0.11174547890894400
18819,65224,1058,610,2492,265349,330573,10166,25.0,0.8019174712851270
2227,3242,436,116,182,11125,14367,1270,10.0,0.45876767920803500
17551,36723,1250,782,2125,160172,196895,10042,29.0,0.4282244243948100
14302,12181,2259,121,825,54052,66233,8606,29.0,0.12031389624174800
225,803,20,13,28,3576,4379,141,7.0,0.5833501416212780
11175,9748,2157,82,1254,53171,62919,7102,11.0,0.06608039219358550
430,694,89,2,43,2414,3108,277,3.0,0.04689777579910560
5174,16205,521,145,702,50045,66250,3370,13.0,0.32065706891308
1949,3333,409,25,150,10511,13844,1303,5.0,0.1024053576184950
3990,13319,402,88,619,44122,57441,2719,18.0,0.24834134074277400
3131,12248,253,93,530,46366,58614,2173,8.0,0.43908561373382200
540,284,141,0,66,1029,1313,377,4.0,0.022222549567540000
6984,23888,408,191,1094,77479,101367,4900,18.0,0.5426819956504680
35285,109984,2903,890,6081,369027,479011,24807,39.0,0.5397875656186760
66935,135447,4192,1492,10441,652233,787680,47229,17.0,0.5194195621068740
41,0,15,0,0,0,0,29,1.0,0.002539871936084700
4331,3812,1125,26,420,14897,18709,3064,6.0,0.04332283216314940
5894,23155,438,227,990,68422,91577,4189,15.0,0.6503716111020020
9899,14482,1621,168,1016,62300,76782,7071,11.0,0.14414438924197700
25764,40673,996,374,2401,237087,277760,18564,18.0,0.5466392655653290
18400,27697,1881,343,2476,154566,182263,13570,11.0,0.28128820844094700
4335,18914,275,146,867,72972,91886,3219,15.0,0.6684811977195570
21214,75618,1104,404,3142,205381,280999,15868,13.0,0.5289061962112500
8595,8542,1103,134,977,40308,48850,6437,12.0,0.15067783215873400
3525,13023,217,103,696,42832,55855,2643,7.0,0.6961940129229180
27488,92944,2139,610,5251,377854,470798,20820,9.0,0.44776549500413700
7019,10934,973,165,851,51259,62193,5324,10.0,0.22627742421016300
251,365,42,4,32,1229,1594,191,4.0,0.109346380454584
7482,7131,1951,70,572,25038,32169,5720,14.0,0.07646216041082400
1058,3563,55,27,111,10551,14114,814,9.0,0.701047351361565
3531,4388,814,27,358,15925,20313,2718,7.0,0.07746883040984720
762,2910,22,9,237,11125,14035,594,5.0,0.5258358379355320
9229,12550,1590,108,920,47577,60127,7198,7.0,0.13615423487154400
14852,27354,743,379,1352,112315,139669,11692,14.0,0.7346827337088160
67,158,16,1,5,615,773,53,2.0,0.0863469964700795
12870,21774,1245,637,1506,62751,84525,10182,29.0,0.760313639555601
193,662,15,9,30,2219,2881,153,6.0,0.6843353529711090
1772,4317,278,22,241,16414,20731,1429,4.0,0.12349239418533700
1776,4228,122,50,204,25771,29999,1433,8.0,0.8254746525706100
6844,27643,457,258,1325,111967,139610,5550,14.0,0.7363716192409210
20211,59436,1037,541,3749,195422,254858,16475,12.0,0.6209530659568360
42762,135781,2578,967,7550,497723,633504,35030,12.0,0.6000009858856700
1093,303,375,7,333,1772,2075,896,4.0,0.034734387216223700
19359,34808,3744,661,2195,107096,141904,15881,19.0,0.31308717561444200
5630,18023,446,205,654,71112,89135,4637,16.0,0.4752264816418930
11904,33705,820,271,1246,183137,216842,9825,10.0,0.5659850562395330
237,1147,15,11,38,5692,6839,196,6.0,0.8037203582823150
30400,92828,2070,831,5832,334829,427657,25236,11.0,0.539986393144639
4552,12450,192,80,603,56601,69051,3780,8.0,0.5775058233366510
1281,1800,221,25,138,7476,9276,1065,8.0,0.2016368068056050
133,0,43,0,0,0,0,111,1.0,0.002152556813333040
1732,176,728,0,133,571,747,1446,4.0,0.009258830427895720
6995,26643,559,210,1351,91997,118640,5849,9.0,0.5130600307065800
1410,2682,303,17,156,9464,12146,1180,4.0,0.09158601155477850
8194,28770,1001,245,1535,113984,142754,6859,12.0,0.3361179454495430
656,282,184,17,61,1243,1525,550,8.0,0.029879045620768100
3169,3132,722,22,201,14645,17777,2658,6.0,0.07372795773927340
10469,21840,726,264,1120,93548,115388,8825,17.0,0.5564275024335190
19071,41944,1895,349,1963,187960,229904,16087,16.0,0.25089600255768800
918,688,176,26,107,3224,3912,775,6.0,0.1674463266078630
7935,30399,525,260,1084,101998,132397,6701,10.0,0.7376218681070020
311,176,121,3,19,665,841,263,4.0,0.023382398868328700
1484,2828,367,33,208,12448,15276,1262,5.0,0.0982010034897736
8708,26860,660,381,1615,92003,118863,7433,15.0,0.5026864911051510
5312,10368,1309,159,556,46957,57325,4539,9.0,0.16306947171678600
406,1496,49,17,64,7859,9355,348,5.0,0.5340050193230120
2379,5735,450,42,355,25596,31331,2044,7.0,0.14084420278332100
967,3753,60,19,185,16300,20053,831,5.0,0.7716609649278130
25258,76251,1510,632,5295,252838,329089,21714,14.0,0.5582507022675540
8560,33070,543,244,1615,108340,141410,7375,13.0,0.6321433329152330
311,1265,16,8,63,5117,6382,268,5.0,0.6799022203759630
478,1866,38,18,64,7067,8933,412,8.0,0.6226314021405630
7716,28360,492,218,1123,117630,145990,6655,9.0,0.6772056480020520
4611,9779,323,134,609,63884,73663,3978,8.0,0.7135621520639490
25187,69641,2912,522,4338,323167,392808,21744,12.0,0.2461653723665570
12858,42938,951,236,2966,157404,200342,11122,12.0,0.33733230034841700
8486,20574,1373,220,2000,86131,106705,7362,15.0,0.2608565695364660
38200,51440,6425,2160,6259,354971,406411,33226,17.0,0.5093890737836980
31623,91355,3400,728,5295,304895,396250,27524,14.0,0.3248751279922030
2476,8653,414,66,745,36117,44770,2158,12.0,0.2716413218357950
2041,7265,169,84,481,28320,35585,1781,10.0,0.6563081406816670
31178,75860,2268,1049,5192,242534,318394,27256,30.0,0.5634878202281100
344,1364,31,13,58,4738,6102,301,5.0,0.5340937599121080
3161,10014,310,112,589,32049,42063,2773,9.0,0.42186203489655700
55368,209851,3075,1668,14531,715770,925621,48596,27.0,0.6487094820506350
232,450,24,6,37,1576,2026,204,4.0,0.43182450800611800
658,2200,94,22,123,7145,9345,579,17.0,0.5098915761869100
1764,6235,179,54,409,23163,29398,1554,9.0,0.5256201419509520
13231,51676,943,395,2523,247292,298968,11667,13.0,0.6675016627722030
127,521,12,7,23,1975,2496,112,5.0,0.39882291140343300
22046,58771,2878,1059,2134,222429,281200,19453,18.0,0.6016230226801920
2047,228,901,7,93,883,1111,1809,4.0,0.017773015052620600
746,453,233,6,260,1425,1878,660,3.0,0.04088730072473410
29340,86835,1625,813,5310,267174,354009,25969,13.0,0.5999977932418510
717,2522,51,25,135,12457,14979,635,5.0,0.6153165769770140
20882,68830,1251,515,4074,288602,357432,18515,11.0,0.8050837440648940
2928,7436,223,86,380,38179,45615,2599,8.0,0.669928444528581
11239,38916,896,443,1613,129790,168706,9980,12.0,0.5787252206489190
127,35,49,1,8,502,537,113,2.0,0.05394143493429340
16882,53290,1070,336,3823,212471,265761,15038,14.0,0.4029158459480500
1405,6158,120,49,335,24456,30614,1256,6.0,0.6161952507645330
367,594,45,12,52,3776,4370,329,6.0,0.35712709715355400
34198,73630,3050,794,4501,250976,324606,30679,14.0,0.41245979780177800
34138,104651,2404,959,6522,445341,549992,30650,16.0,0.496889516264382
13644,34267,2461,693,1588,132861,167128,12266,16.0,0.3597460557290830
1761,5775,198,78,343,16537,22312,1584,10.0,0.4465153761258480
799,3153,71,23,123,11953,15106,719,7.0,0.4407965596305500
2199,5798,294,163,397,24698,30496,1979,6.0,0.5126822343393180
3326,7289,649,104,642,21822,29111,2998,18.0,0.17063047853513000
194,795,32,5,13,3137,3932,175,4.0,0.564743533895953
6469,13604,455,149,842,61282,74886,5836,9.0,0.5018417424277230
247,940,9,4,111,3367,4307,224,3.0,0.55745714353339
594,1920,61,26,109,11289,13209,539,5.0,0.5421533963375850
477,18,145,6,0,96,114,433,2.0,0.007670839587220800
1966,7618,158,59,372,29042,36660,1787,7.0,0.5687318914788260
35196,94736,2020,980,7049,330986,425722,32006,25.0,0.6948675791276710
4987,18548,301,137,1189,69686,88234,4545,7.0,0.7877568282712870
260,503,47,4,22,3164,3667,237,3.0,0.11934692715741300
3581,9145,724,84,481,35803,44948,3271,15.0,0.17305260837630600
9637,22918,1396,220,1307,73717,96635,8811,13.0,0.2597346292985490
222,661,45,5,37,2914,3575,203,5.0,0.15274245073689800
1534,2845,362,28,350,11621,14466,1404,7.0,0.12327883936114000
1325,513,425,5,117,2493,3006,1213,3.0,0.030508461408494400
2956,9011,214,90,443,29174,38185,2708,6.0,0.6427186601730570
765,3032,48,15,102,14498,17530,702,3.0,0.7148367905696430
10597,20312,602,205,1916,56266,76578,9725,8.0,0.5939211123971070
4030,14841,324,144,794,51860,66701,3699,15.0,0.5745467151547650
7890,26315,588,200,1505,82542,108857,7264,17.0,0.3921475367427050
5320,19140,373,154,774,83778,102918,4906,8.0,0.6673225625140050
1675,4968,171,79,262,19551,24519,1546,12.0,0.6320285956293290
6259,26018,283,184,1443,105710,131728,5777,24.0,0.7567039923686350
26900,65458,3034,1137,4392,242053,307511,24844,41.0,0.6051676136432480
7696,21752,744,231,1263,87611,109363,7112,11.0,0.42935716661371800
13544,42045,977,504,1830,131573,173618,12530,23.0,0.7759365557936390
9706,28042,939,230,2138,110374,138416,8980,9.0,0.38497355474693600
12247,28600,1177,256,1097,90493,119093,11337,13.0,0.3769779851215120
45764,128437,3272,1232,7133,409748,538185,42428,15.0,0.5416513410112810
742,1192,220,9,67,5624,6816,688,5.0,0.06338415305828900
15305,25453,1522,482,1226,116725,142178,14211,10.0,0.6147208169924850
40392,123862,3310,1160,5979,498485,622347,37529,16.0,0.49985611831079800
5539,18549,461,206,822,74042,92591,5156,10.0,0.5610030164605060
1179,4528,110,57,261,15637,20165,1098,9.0,0.5721952619231680
16901,32378,1576,402,2605,144214,176592,15775,11.0,0.3605506815737140
7213,20891,327,128,2403,61572,82463,6736,9.0,0.6673673544250150
3663,13188,224,113,610,44146,57334,3424,7.0,0.7740425187217860
21771,60473,1312,556,5618,181943,242416,20358,17.0,0.49027419290883600
362,1626,31,8,90,6839,8465,339,3.0,0.47306362584172800
38917,110293,3250,609,8523,334564,444857,36456,14.0,0.27542343148118300
3423,8627,491,100,676,31069,39696,3208,8.0,0.25092424470144100
27011,98332,1366,588,6063,305319,403651,25321,11.0,0.6322993161877750
14541,38665,1841,997,3002,184373,223038,13650,29.0,0.412475564226233
22423,62079,2040,504,5052,272867,334946,21062,11.0,0.36906045977071900
30820,87816,1436,487,4317,409916,497732,28957,11.0,0.564872489991863
322,1323,20,7,56,5549,6872,303,4.0,0.723237731967904
33072,103340,2151,666,7021,380179,483519,31147,16.0,0.43691700235121000
31153,59935,2554,1064,3548,370434,430369,29344,13.0,0.5712331832539240
10557,14048,1888,112,928,72546,86594,9948,11.0,0.10328510979382500
279,938,34,15,77,3158,4096,263,12.0,0.3867572404535460
6784,20654,683,372,1135,79405,100059,6397,13.0,0.525107585837239
958,4219,55,33,169,12338,16557,905,9.0,0.6546760486068700
364,484,47,12,24,2353,2837,344,5.0,0.7571014814220790
9154,34500,1109,580,1442,125857,160357,8678,30.0,0.6278271881286280
3219,12156,233,109,447,46449,58605,3052,25.0,0.7090259838946570
195,956,15,8,39,3486,4442,185,3.0,0.5920541158057990
6939,32222,497,209,1841,167278,199500,6610,7.0,0.7138053470742130
8667,39633,763,248,2024,185312,224945,8262,12.0,0.4783973830041720
5604,8397,751,212,379,38636,47033,5344,11.0,0.47560450319052000
3992,14523,396,206,772,57613,72136,3811,23.0,0.6819911915362430
22085,56603,1685,456,3987,229829,286432,21089,14.0,0.41654112310585700
5218,17957,899,237,750,77925,95882,4984,14.0,0.4242753320647750
15289,44407,1814,464,3451,191529,235936,14607,12.0,0.2814850781986440
17023,58973,1098,381,4322,255834,314807,16268,15.0,0.6118739477370010
5746,20177,877,239,1292,62254,82431,5494,14.0,0.316597333675952
20820,77630,1227,551,4558,313663,391293,19929,13.0,0.601064486303457
3979,11012,440,148,685,56385,67397,3809,7.0,0.6854462060774420
29284,81661,1855,654,4826,230746,312407,28047,11.0,0.7222087363512870
21133,54961,1791,487,3581,181316,236277,20256,16.0,0.36100491748929
4074,4189,1291,63,331,25564,29753,3905,7.0,0.07797938414035800
13127,37176,926,313,2249,144633,181809,12586,8.0,0.5512200920390810
11191,35634,1023,463,2594,158210,193844,10731,12.0,0.46376162049386500
200,780,31,7,31,2750,3530,192,4.0,0.31658246403390400
16627,48956,2968,304,3633,248851,297807,15983,12.0,0.1827725157510900
4876,6304,1403,27,863,28161,34465,4688,5.0,0.04587049629265870
3514,9017,583,79,336,28065,37082,3380,16.0,0.23873694070470400
15499,47495,1947,396,2378,193742,241237,14918,10.0,0.3367823613708100
21803,81361,2442,864,4029,327230,408591,21032,30.0,0.5302575200967390
8929,30309,825,341,1940,130916,161225,8623,18.0,0.40579806976998400
22246,62647,1425,531,4992,286917,349564,21496,11.0,0.5793289967695270
11478,10937,1904,142,1528,50416,61353,11107,8.0,0.12613091570924700
8796,22263,1452,188,1654,87859,110122,8512,10.0,0.19869782332177900
14339,31207,1617,565,2269,166885,198092,13888,14.0,0.4187982758770740
5247,16773,291,170,874,64234,81007,5082,12.0,0.6501548457618180
1534,6800,106,50,396,30365,37165,1487,8.0,0.5091630664087980
8726,29274,542,246,1574,112125,141399,8461,11.0,0.7187615720939650
1968,7901,208,119,369,27941,35842,1909,12.0,0.6422678602123130
2430,6115,450,67,389,24824,30939,2359,6.0,0.23174919996325500
11844,25231,1316,139,1385,119414,144645,11507,8.0,0.2078169618356700
12556,32177,939,280,2332,126401,158578,12202,11.0,0.47909328868485500
3314,8374,285,155,690,30813,39187,3229,9.0,0.6835435874102230
547,0,255,0,0,0,0,533,3.0,0.00543667183243646
3106,8555,752,102,458,39735,48290,3027,9.0,0.1777832883018940
4753,21934,320,139,948,95160,117094,4639,7.0,0.8054531803596550
19793,59813,1312,466,4930,197263,257076,19319,12.0,0.4421548715898580
963,376,381,6,17,1478,1854,940,5.0,0.01809094927155010
3324,10945,198,104,747,49725,60670,3245,9.0,0.7790873477918810
13564,49050,1208,418,3240,222905,271955,13247,13.0,0.5862927759866720
22974,47031,2415,449,5514,265123,312154,22460,13.0,0.282648414191229
14449,32122,981,386,1880,97969,130091,14132,23.0,0.6206917042862930
2886,5588,109,53,588,25751,31339,2827,7.0,0.5479090685358250
4329,19669,400,149,839,68674,88343,4242,11.0,0.5738768015736290
3790,16559,284,126,779,91504,108063,3715,9.0,0.6444870226555750
4604,1274,1473,10,675,6570,7844,4514,5.0,0.021235920452004500
688,82,267,2,90,405,487,675,2.0,0.011739401879218400
433,1325,68,15,55,6036,7361,425,5.0,0.2983364914573650
8927,24513,708,276,1363,135677,160190,8785,13.0,0.6395243432626350
1134,4485,72,29,313,18171,22656,1116,7.0,0.6326745944555990
1018,3481,92,34,212,14816,18297,1003,7.0,0.4993586866273050
296,1237,66,9,66,7057,8294,292,4.0,0.3000719019971230
5894,1358,2314,32,255,7596,8954,5822,5.0,0.028717999329537100
11110,44388,718,274,1702,155205,199593,10982,9.0,0.633885349544294
1245,3515,179,28,296,14042,17557,1231,7.0,0.23557000271031300
3540,13178,417,111,780,65565,78743,3501,7.0,0.4824585624949290
3033,9846,421,167,583,42460,52306,3003,9.0,0.3820261340784040
24800,59279,2200,528,4293,209342,268621,24561,12.0,0.38631285534982800
9943,29058,1058,273,2096,117184,146242,9848,11.0,0.3282365875639530
28952,103659,1459,719,7917,312910,416569,28704,13.0,0.6628068453911270
12980,56698,1525,579,3492,183514,240212,12871,34.0,0.4468978268343330
1390,4887,284,80,200,22808,27695,1380,11.0,0.41095993479467800
28002,34053,2023,689,2893,225637,259690,27824,52.0,0.49098117361175
29849,52514,2332,820,3505,272581,325095,29660,21.0,0.5474530199658390
714,1121,21,11,69,6267,7388,710,5.0,0.5673089549552270
5892,19921,901,247,689,55870,75791,5864,14.0,0.3474470803141760
2512,8653,309,78,463,40659,49312,2503,12.0,0.3915888346841340
2760,618,1152,12,43,2561,3179,2751,5.0,0.017011447023553200
1259,4727,77,36,271,20935,25662,1255,4.0,0.7237364817439250
30799,114304,2930,1114,7148,500180,614484,30743,15.0,0.41263764549453600
7071,10937,2114,306,840,54059,64996,7063,10.0,0.16457251443649600
3849,13396,607,107,765,51349,64745,3851,12.0,0.3160661315372620
38357,88710,2146,697,7287,378354,467064,38379,11.0,0.4475418177709410
1980,7532,178,82,334,28682,36214,1983,9.0,0.6909211019717320
2604,6400,184,71,478,21577,27977,2609,7.0,0.5455998338858820
2361,9611,225,109,417,36861,46472,2366,14.0,0.6330298651256850
659,2110,136,63,112,3834,5944,661,12.0,0.2530572736838560
3206,7245,275,111,1248,32048,39293,3220,12.0,0.46693450034264200
19437,76115,1320,632,3397,311405,387520,19522,10.0,0.7630821902746400
6069,26883,455,198,1480,111285,138168,6097,9.0,0.7817844273538420
5220,19666,571,277,823,84621,104287,5246,14.0,0.7835031937711440
10894,53474,1342,613,2680,255864,309338,10950,16.0,0.5518301017426700
6860,16235,748,347,1090,97379,113614,6901,7.0,0.7421972167173550
16561,38584,2444,428,3303,128939,167523,16674,35.0,0.28264261035483800
9038,21646,961,414,2179,101822,123468,9103,10.0,0.3685964958682670
6804,28605,376,180,1551,142067,170672,6857,13.0,0.7851154922065380
5308,23612,310,148,1514,103016,126628,5351,10.0,0.5862780110183030
364,1061,79,9,45,5107,6168,367,5.0,0.1503041732577080
16321,48201,1891,609,3825,216713,264914,16465,25.0,0.44406848855946500
3086,12790,374,146,862,57243,70033,3115,11.0,0.6267024891569980
18110,74323,1591,799,3340,481066,555389,18295,11.0,0.6783104868565710
19904,51330,2007,537,4985,210814,262144,20111,20.0,0.3307728593972940
26602,84060,3812,923,5077,411582,495642,26895,13.0,0.275328599767383
5952,23816,546,271,1272,83807,107623,6019,19.0,0.6832600131385000
7405,6759,1025,72,699,28832,35591,7492,7.0,0.14452703667922200
38502,119936,1882,914,7916,375400,495336,38962,22.0,0.6281754059162460
16477,36890,1326,718,2827,106112,143002,16690,24.0,0.7719864293322590
25660,85414,2317,601,6294,357563,442977,25998,15.0,0.3812731636036840
17731,63171,1116,434,3758,208196,271367,17965,10.0,0.6045659927327350
6346,10598,440,195,666,67675,78273,6434,8.0,0.6436954397559290
9950,32115,852,238,3364,126284,158399,10093,15.0,0.3670144562932690
30858,50516,2554,740,4395,247640,298156,31302,28.0,0.47655067992450600
45125,155702,3020,902,9534,733107,888809,45798,10.0,0.5916152503505500
259,1074,21,10,54,4157,5231,263,6.0,0.7991562136800650
579,72,308,1,2,342,414,588,2.0,0.005371319423721490
3802,10529,419,82,816,44488,55017,3862,11.0,0.32052592771150200
118,314,21,14,9,1311,1625,120,7.0,0.5805116252577590
682,2426,105,19,191,11869,14295,694,6.0,0.22120812482029700
7119,17370,1830,340,1121,69647,87017,7257,12.0,0.1559070823621370
7503,22348,816,288,1196,75387,97735,7651,17.0,0.683880245501784
3263,7219,240,104,390,31550,38769,3329,9.0,0.6765901902536850
30111,54286,4022,1097,4007,384920,439206,30752,22.0,0.4578012592716920
10001,44371,579,244,2203,163901,208272,10221,10.0,0.7663503504206070
1096,4424,100,38,253,13567,17991,1121,17.0,0.5111992351105580
6721,22073,721,151,1815,101906,123979,6876,10.0,0.28967406249695900
124,440,21,9,26,1680,2120,127,6.0,0.3486828649125670
38,50,17,1,2,216,266,39,2.0,0.047423668795866900
2471,26,1288,2,248,183,209,2541,9.0,0.01658761365533530
1865,7688,143,68,360,41094,48782,1919,7.0,0.7413641009262270
7953,15948,2121,204,1080,63388,79336,8193,15.0,0.16302251593164500
4790,10384,1320,88,811,49914,60298,4935,11.0,0.1255646634619150
10380,23068,2810,266,1573,79738,102806,10696,31.0,0.1748083929782040
1613,6571,164,78,241,24311,30882,1664,8.0,0.6471738112185050
11042,32415,1094,497,1953,143051,175466,11394,49.0,0.755028664435975
5723,9355,1877,112,714,53278,62633,5906,8.0,0.08804589383306040
2732,8282,198,54,770,27154,35436,2820,6.0,0.4914576535238660
32052,52056,2802,687,3938,336446,388502,33100,10.0,0.3962773105131110
20435,40235,2285,517,2430,224591,264826,21119,14.0,0.3534356960240780
11355,26867,1266,220,2329,141132,167999,11744,8.0,0.23620708749855100
11331,45398,810,396,2615,191186,236584,11720,20.0,0.6810221519000460
15953,38847,3092,277,2982,200221,239068,16511,8.0,0.15026383431257900
56,221,11,1,11,672,893,58,2.0,0.27908067780538000
11611,38777,1201,528,2842,135387,174164,12032,11.0,0.37443824269930300
27,119,3,2,12,730,849,28,3.0,0.3909728708023720
7096,21047,421,216,2282,121166,142213,7359,12.0,0.6968597040224450
755,3052,56,20,170,11107,14159,784,8.0,0.6931752209820870
2954,11975,338,112,468,46860,58835,3069,8.0,0.5356155368320200
898,234,219,4,114,1468,1702,935,3.0,0.053434921906433400
6286,24956,559,251,1081,83019,107975,6546,10.0,0.7219061543595790
2306,8850,318,82,458,39620,48470,2403,8.0,0.3898323829713850
5587,24498,855,272,1444,102356,126854,5825,40.0,0.5962653723657160
26346,94744,3659,843,4364,389170,483914,27498,10.0,0.33887886981442600
4661,14727,382,201,945,39990,54717,4867,22.0,0.6182831099112760
25527,83744,1472,652,6628,299423,383167,26662,17.0,0.6196722405059820
1600,4284,274,42,291,20492,24776,1672,6.0,0.22677403435521000
9013,14425,1098,363,627,79771,94196,9422,11.0,0.5208865238966260
3537,7407,302,141,415,19347,26754,3698,10.0,0.6974662083548130
20483,33685,1542,368,2717,138481,172166,21436,8.0,0.4389480395234030
3083,12741,332,111,721,48468,61209,3231,7.0,0.5358402412625050
11763,18741,691,218,2139,123139,141880,12328,9.0,0.4981623646092910
4327,7081,336,159,510,34821,41902,4537,9.0,0.759500506188642
6536,26680,617,238,1426,103168,129848,6855,9.0,0.41904940570695100
12542,45099,2142,661,2222,167672,212771,13155,14.0,0.4554181260722160
4248,8812,1022,154,626,39459,48271,4468,12.0,0.15995215712388100
27120,63612,1783,681,7393,289343,352955,28528,14.0,0.5928062002159040
1864,6816,167,64,387,21652,28468,1961,6.0,0.5439499995325450
17065,35588,2096,750,2446,258133,293721,17958,20.0,0.4466186930973210
23494,70343,2366,694,5131,289675,360018,24734,23.0,0.4681627323463350
15427,49539,1529,647,3071,191737,241276,16243,11.0,0.4550042938547580
7608,13070,793,281,747,57606,70676,8012,9.0,0.6252277896533780
5540,18655,581,191,1363,85552,104207,5835,11.0,0.4694931219244240
317,1168,40,10,80,6290,7458,334,4.0,0.388885612287379
19526,63602,1464,934,4956,266612,330214,20577,19.0,0.6225429011635950
20576,72637,2907,821,3938,319234,391871,21708,32.0,0.43669222996873300
3284,11772,255,128,532,49715,61487,3471,12.0,0.688906165614997
10366,23103,662,308,2187,68055,91158,10960,11.0,0.6961122075097720
1353,6176,127,43,344,20313,26489,1431,7.0,0.4177101821118920
3711,13071,424,81,760,49248,62319,3926,6.0,0.31536949203845500
7485,24587,597,312,1191,78019,102606,7920,11.0,0.7416285862430030
2740,10178,274,131,458,45620,55798,2900,12.0,0.6560227401070390
3075,11950,297,122,841,52216,64166,3264,8.0,0.8498642331557320
3200,12185,499,243,662,40768,52953,3403,19.0,0.4365937138330240
2347,5195,153,83,230,15101,20296,2496,10.0,0.7602022269654680
12876,48605,1747,324,2889,252622,301227,13695,13.0,0.31472462482631500
1233,2711,78,32,197,7274,9985,1312,8.0,0.7488551087861380
900,3078,71,31,149,10257,13335,958,6.0,0.7293086018979110
93,347,12,2,24,2274,2621,99,3.0,0.2905639775891320
3756,13089,352,117,897,46546,59635,3999,8.0,0.5341030573471410
6598,26891,495,166,1603,122536,149427,7030,9.0,0.5543299937711000
4655,774,1048,13,298,5383,6157,4961,4.0,0.020528309668523800
1004,3317,208,65,244,34340,37657,1070,19.0,0.5584055973457770
2440,3945,787,48,327,16735,20680,2601,11.0,0.10981556082666600
16220,43075,2109,337,3546,163545,206620,17291,12.0,0.2428177522707120
1442,5354,131,53,276,19726,25080,1539,8.0,0.5534375542953750
3874,15214,294,131,870,59960,75174,4138,8.0,0.5803169629039360
704,1023,227,11,156,4069,5092,752,4.0,0.07998208963784710
9952,25580,1024,350,1928,99960,125540,10632,10.0,0.5106861110245820
1408,260,685,4,73,1353,1613,1506,4.0,0.013860612826980500
7393,12335,694,199,1357,93984,106319,7918,15.0,0.4671569432533160
1220,5127,119,49,201,19747,24874,1308,7.0,0.6977071533725540
2837,8535,659,67,598,31407,39942,3043,9.0,0.1369392136833750
13937,45317,1000,363,2766,151110,196427,14952,10.0,0.5512381053185610
41,98,16,0,3,301,399,44,1.0,0.0500895409337431
10744,39418,1117,440,2111,167626,207044,11537,51.0,0.6951328652614720
946,3504,116,50,121,16293,19797,1016,7.0,0.6033621873859920
215,152,54,6,45,2669,2821,231,4.0,0.18146792170737400
2209,10508,209,79,593,46483,56991,2374,7.0,0.6013845703627200
7751,27281,654,297,1751,93164,120445,8330,11.0,0.5217233517698140
10295,18214,867,274,1110,123024,141238,11081,11.0,0.6403948623757230
3496,6097,267,115,409,30719,36816,3765,10.0,0.6972157467853850
737,1630,151,37,88,7424,9054,794,6.0,0.3488954668154470
25522,49395,2447,888,3754,236412,285807,27513,17.0,0.5939750050473060
433,1760,14,8,90,5649,7409,467,3.0,0.8292851835364580
10083,45322,1132,339,1986,160825,206147,10875,21.0,0.5022262395873500
20859,51034,902,541,3962,174936,225970,22505,25.0,0.6856428466997080
9807,12773,1348,562,586,73916,86689,10585,10.0,0.7214991216702150
2288,9832,189,84,412,28626,38458,2471,7.0,0.7385228737063270
57116,158128,4181,1494,9650,660264,818392,61691,10.0,0.6022637421914640
585,38,124,0,3,298,336,632,3.0,0.011456688842629500
826,3629,68,25,217,17355,20984,893,5.0,0.6822373372816030
15074,54913,1489,678,4063,322553,377466,16301,22.0,0.6115354158199700
5871,19209,643,188,1152,87241,106450,6349,12.0,0.3543849713022940
620,2049,99,26,88,11955,14004,671,6.0,0.6438650990250230
933,3954,70,33,174,16177,20131,1011,8.0,0.6758567210590730
14886,65095,1232,562,2759,306262,371357,16141,10.0,0.6558142255773950
1101,3738,227,23,237,17287,21025,1194,6.0,0.25327188515753100
331,1130,56,13,72,4706,5836,359,6.0,0.407895177297578
5049,8156,946,188,687,44073,52229,5479,10.0,0.31897877070313400
281,1086,31,14,90,6211,7297,305,5.0,0.7336977800421580
51595,145596,6231,1192,10472,600193,745789,56067,11.0,0.28534184349452700
223,634,11,3,56,2913,3547,243,2.0,0.4076891198701190
602,209,274,4,85,1335,1544,656,4.0,0.017056505812421400
78,250,17,7,17,936,1186,85,3.0,0.2566662665602770
11961,17623,3011,190,1376,111891,129514,13039,9.0,0.10739379318322200
28873,104830,2130,836,6878,453158,557988,31485,9.0,0.5526946523457460
667,1584,152,17,130,6412,7996,728,8.0,0.14451457582580700
3656,14473,436,175,703,85861,100334,3992,10.0,0.5688695610291080
14547,33621,1014,496,1785,218377,251998,15915,11.0,0.7945858160701100
5281,8064,1304,87,690,48820,56884,5788,10.0,0.1570326231690610
35623,60700,2071,1104,3877,255778,316478,39058,14.0,0.6561703388591470
3230,7467,507,91,1184,40347,47814,3544,8.0,0.2646306960690790
15471,38725,913,392,2328,169710,208435,16992,33.0,0.6309023550377870
4739,7233,1591,92,943,56768,64001,5205,9.0,0.10839464495915100
6211,5475,2011,64,743,29397,34872,6826,8.0,0.0624272696439585
4807,12885,504,229,761,40365,53250,5284,13.0,0.4893598419113540
211,525,33,4,42,4078,4603,232,3.0,0.17991149069385400
2700,10233,306,114,583,33105,43338,2970,11.0,0.43390504750915500
16556,54532,1239,603,3336,258710,313242,18217,15.0,0.6492065695339380
20300,23267,1031,517,1906,185284,208551,22352,10.0,0.7574819197008420
22373,59368,2417,986,2948,278495,337863,24642,10.0,0.5508933387802320
2155,8138,131,61,915,53259,61397,2376,8.0,0.5577172148538690
9272,33173,644,212,2167,119983,153156,10239,7.0,0.49143387870118200
67,0,37,0,0,0,0,74,1.0,0.0016265560882704600
11328,32361,1566,594,1399,131438,163799,12514,16.0,0.5074544638975270
3045,9307,290,111,483,32201,41508,3369,9.0,0.566872842993583
225,419,30,6,33,1554,1973,249,5.0,0.21337019054149000
7783,23349,837,178,1655,90714,114063,8614,9.0,0.3121141477050800
44067,132368,3782,1044,9598,457669,590037,48819,18.0,0.42843173527647700
8778,21426,1028,430,1502,105256,126682,9726,32.0,0.48915512231858900
5437,14850,539,198,1092,40761,55611,6026,11.0,0.4693454828021080
576,2228,70,19,175,8514,10742,639,5.0,0.486364996741763
2469,19947,1230,51,1311,51705,71652,2740,42.0,0.24163694190655600
7102,23640,602,177,1890,94030,117670,7884,12.0,0.33846286618503300
14036,41801,949,395,3306,153929,195730,15589,12.0,0.5772678377641940
7244,22968,996,266,1871,93118,116086,8056,7.0,0.35509200025065500
418,0,120,0,31,0,0,465,2.0,0.0034114083748922600
10070,37455,838,358,2138,155941,193396,11203,12.0,0.7212443134166520
4166,15746,305,148,892,62915,78661,4636,11.0,0.6519973103656470
5458,16127,585,250,766,83680,99807,6081,9.0,0.6972152238235170
381,0,209,0,76,0,0,425,1.0,0.001610504735827830
268,0,133,0,36,0,0,299,1.0,0.0016102361275185800
682,2599,76,30,80,13449,16048,762,8.0,0.5595424349225550
32059,87028,2554,965,6358,514627,601655,35855,8.0,0.6200959820817210
11707,33384,1583,250,2484,170715,204099,13094,10.0,0.2608741014934070
39064,145281,2620,942,10008,631184,776465,43718,12.0,0.5340385792362080
217,735,31,12,41,4294,5029,243,4.0,0.6381081743720390
242,0,121,0,42,0,0,271,4.0,0.006993734306949090
7130,25374,954,188,1541,85979,111353,7985,16.0,0.29321854889906700
856,2224,89,24,224,10723,12947,959,7.0,0.5307742039874020
191,804,14,6,38,5139,5943,214,4.0,0.7912911922192850
2122,6097,448,115,446,23222,29319,2378,13.0,0.22363060300160400
8187,16557,854,238,1364,89765,106322,9178,11.0,0.43717719259299300
649,1704,41,11,125,8387,10091,728,5.0,0.4828167727181590
50600,83613,3827,1539,7371,435537,519150,56771,38.0,0.5627793378315630
252,1130,28,15,76,6578,7708,283,8.0,0.5874109904735030
28278,84419,2561,1135,6540,292433,376852,31759,81.0,0.8060240742681350
12340,41563,1923,371,2639,201235,242798,13862,14.0,0.33155844386531700
281,1234,28,16,57,4941,6175,316,9.0,0.6246219070433720
880,1549,232,17,168,14118,15667,990,6.0,0.11120165050895300
184,662,34,16,25,2293,2955,207,3.0,0.38072068938740000
17776,41810,2469,390,4311,119317,161127,20005,17.0,0.22300131959382700
338,1459,28,9,60,5546,7005,381,3.0,0.808733183046476
4107,7068,1293,70,669,26996,34064,4630,10.0,0.11207674335498700
2334,7642,410,80,409,33885,41527,2634,10.0,0.2627566546003860
9382,15348,1129,289,1462,81703,97051,10592,12.0,0.3931485246548490
2066,39,346,1,280,175,214,2333,3.0,0.010529754677017100
25177,72461,3887,1057,5026,415655,488116,28450,17.0,0.4928201729047370
2917,6900,314,143,519,19882,26782,3297,7.0,0.46656348107945400
630,2392,59,39,119,9184,11576,713,10.0,0.7608104206527520
5367,9487,565,254,625,75426,84913,6075,10.0,0.6925686217987010
3982,10707,384,165,1088,68926,79633,4511,24.0,0.4311015258064800
16338,62506,1830,446,3654,324313,386819,18509,7.0,0.47090482232819500
9655,18371,1304,542,831,121569,139940,10961,17.0,0.6546545870022480
375,1056,75,13,44,5257,6313,426,3.0,0.3367833949066330
59563,200845,7479,3745,12300,965775,1166620,67888,21.0,0.8294398070760510
2266,7233,452,43,653,28039,35272,2583,7.0,0.1980457760437890
50,2,29,0,0,0,2,57,1.0,0.01931780731258810
11621,29663,2016,289,1978,134483,164146,13255,11.0,0.26880719686452000
379,1566,43,7,109,9987,11553,433,3.0,0.4149333676822840
8320,28078,1028,265,1497,141873,169951,9510,9.0,0.5092191812665820
4530,9266,439,191,609,47031,56297,5183,10.0,0.686790915823111
2518,11038,206,95,684,59267,70305,2881,8.0,0.8812909617307920
16454,29661,1598,456,1517,173734,203395,18834,12.0,0.5812392098865830
22216,61932,3510,866,3820,197269,259201,25466,17.0,0.389941348543233
4986,7106,465,124,701,47393,54499,5721,9.0,0.4461320862438540
2270,9333,126,70,864,39494,48827,2607,14.0,0.616895097561017
10074,17239,886,251,1174,62795,80034,11571,10.0,0.5578164432853320
67,320,5,1,19,1436,1756,77,2.0,0.6983875806143010
5718,14864,1036,346,1103,72370,87234,6575,17.0,0.42859261399974300
8388,15559,1489,185,1405,86338,101897,9656,11.0,0.22760330344205100
977,4167,84,37,298,18326,22493,1125,7.0,0.6952466751996900
7512,29285,885,420,1548,134926,164211,8653,13.0,0.5986016074708540
3586,2752,940,28,497,19420,22172,4137,5.0,0.052331516555144700
6271,25016,534,238,1233,133881,158897,7244,10.0,0.661495870022696
7740,3129,1852,77,703,28418,31403,8945,6.0,0.0656532638362623
210,427,59,14,39,4124,4551,243,4.0,0.3763500568141110
610,3023,79,33,133,14122,17145,706,5.0,0.6027548768029150
5228,21030,491,209,1025,91560,112590,6060,12.0,0.6467373494354080
15524,67113,1223,467,3644,402580,469693,18000,10.0,0.691463012382104
11366,39575,2244,366,2878,188411,227986,13193,31.0,0.38517075950875600
2348,9261,231,105,446,37203,46464,2728,12.0,0.7511169779359960
1803,1981,505,85,224,22920,24901,2097,6.0,0.2930513399352470
1169,4193,93,34,279,20788,24981,1360,6.0,0.5744637650131630
3425,8507,441,78,547,48009,56516,3991,9.0,0.27631987211377500
1813,6282,160,94,400,24226,30508,2114,9.0,0.810098092416133
12,41,2,1,3,121,162,14,2.0,0.29868008995556000
60,274,4,2,21,1112,1386,70,2.0,0.5958203272390690
788,2289,142,40,130,8721,11010,921,7.0,0.38293037849432100
3533,15344,394,212,945,62191,77535,4130,10.0,0.6393325808635040
5639,11143,516,202,948,30689,41832,6595,10.0,0.578871011020073
10324,35597,906,337,2911,131140,166737,12081,19.0,0.45700732567317100
2118,6819,245,88,339,32268,39087,2480,8.0,0.6949592532488420
35,71,9,2,4,298,369,41,3.0,0.16481500792623300
7764,32602,1153,437,1106,125227,157829,9099,9.0,0.6900357227461260
58,173,10,4,18,955,1128,68,4.0,0.8581728772057670
10577,36028,1182,318,2187,147179,183207,12425,14.0,0.4388167985826990
1546,5003,178,61,220,16385,21388,1818,7.0,0.5419052691974750
329,121,123,3,111,785,906,387,3.0,0.03198295123856350
147,621,15,3,46,3638,4259,173,2.0,0.5878784456016720
277,1268,24,11,87,7689,8957,326,5.0,0.5729914603038890
101,398,21,6,22,2562,2960,119,3.0,0.49588590170224700
14977,22229,1317,599,2615,156973,179202,17671,17.0,0.5673270770024190
5601,12862,636,187,1068,64481,77343,6611,10.0,0.38495277428429400
698,2863,81,33,124,10629,13492,824,8.0,0.6814351806645780
26085,43971,1386,583,2445,218701,262672,30797,10.0,0.5922645888130310
11,42,1,0,2,512,554,13,1.0,0.8580888240108930
4581,16826,498,186,1117,66674,83500,5418,15.0,0.5259309418257350
183,775,31,9,53,4958,5733,217,4.0,0.41724708994795300
473,399,95,14,72,2372,2771,561,9.0,0.21016526904281900
50302,179357,5528,1668,8242,697394,876751,59707,13.0,0.4663215697524850
16,0,9,0,0,0,0,19,1.0,0.0015128377128925500
3583,10669,1125,122,455,55368,66037,4255,13.0,0.18160298950816100
142,219,50,1,9,760,979,169,2.0,0.045559532929625400
3274,11707,345,136,657,50141,61848,3906,10.0,0.7613293811913190
11266,48951,1585,442,2762,242601,291552,13459,18.0,0.5476347892352850
9758,27691,689,283,2403,119360,147051,11661,10.0,0.6269614515230780
14451,28901,3137,1059,2486,188916,217817,17276,14.0,0.4391974653656540
3032,7512,797,60,850,40445,47957,3625,9.0,0.11679384917107600
1698,1944,639,26,154,8564,10508,2033,5.0,0.07186458446010390
8188,22035,788,360,1311,117143,139178,9809,14.0,0.6599961123259220
11005,43102,1718,586,2158,171554,214656,13184,13.0,0.7686727020072880
3981,15853,437,186,673,78218,94071,4770,6.0,0.6216518047692920
3868,11454,343,123,1450,93154,104608,4637,7.0,0.6849606013318210
5,18,1,0,2,94,112,6,1.0,0.3665448191076900
5,6,1,0,0,38,44,6,1.0,0.3378009025627320
741,3687,78,27,173,18657,22344,890,8.0,0.6668344861696510
2128,6901,418,56,432,39167,46068,2556,7.0,0.1882382975976870
8597,25913,1880,297,1745,133079,158992,10356,10.0,0.2149485711953640
1971,7843,211,92,440,51400,59243,2375,7.0,0.7236818047581390
1194,4843,145,48,216,20453,25296,1439,7.0,0.5049105919495060
8314,23421,726,272,1531,76287,99708,10045,9.0,0.520716468825283
1371,1053,562,40,546,9145,10198,1658,10.0,0.1041158799270430
8885,32680,1177,475,1971,94866,127546,10745,11.0,0.4759512347386940
2409,4017,445,89,247,20779,24796,2914,8.0,0.3255381001640700
993,4232,204,39,272,17665,21897,1203,7.0,0.31728554000828000
501,390,222,5,27,2015,2405,607,5.0,0.030964710137183000
2596,5385,638,70,402,46486,51871,3148,8.0,0.16338339251680400
168,24,59,1,0,226,250,204,2.0,0.02042487399855310
1366,2576,444,25,346,11288,13864,1660,9.0,0.07708971078656170
406,1946,65,28,119,7159,9105,494,7.0,0.46048365258715300
38924,137200,2157,1034,11229,606043,743243,47363,18.0,0.679633109509135
226,23,126,1,4,116,139,275,2.0,0.01010527019861420
1339,5504,142,39,388,24758,30262,1631,7.0,0.3557335163620690
87,285,11,1,13,1102,1387,106,2.0,0.4378267328454370
596,1996,39,19,152,8578,10574,727,7.0,0.6341153275699710
364,674,121,3,60,3112,3786,445,2.0,0.06856931490054590
1211,57,715,0,74,509,566,1481,4.0,0.009055461573418970
2888,5912,298,94,834,19866,25778,3536,8.0,0.5007891325324190
2164,5806,309,120,390,30246,36052,2650,6.0,0.7225125895133970
8190,18098,1153,444,1222,95358,113456,10037,9.0,0.42137763017946000
264,1002,27,13,42,3751,4753,324,4.0,0.6871792159560720
6725,20683,794,300,1455,104724,125407,8260,26.0,0.6046984399777800
3427,5035,804,100,431,41742,46777,4215,10.0,0.18473706919053900
8839,37237,1336,455,1828,195574,232811,10883,11.0,0.6526303535359720
30,109,6,3,10,311,420,37,2.0,0.2506903271010590
6326,24161,421,204,1792,127581,151742,7830,12.0,0.6840707927113040
12933,19236,1523,696,1361,300787,320023,16009,11.0,0.68283547986795
42,152,9,5,9,852,1004,52,3.0,0.25942766600889800
8959,39977,1103,509,1996,209150,249127,11098,11.0,0.6221031958436850
2833,6910,526,81,491,22206,29116,3523,11.0,0.23224845438723300
3995,485,1634,10,327,2050,2535,4972,3.0,0.017464610127241500
98,400,9,2,15,2423,2823,122,3.0,0.6343681594515430
7422,19487,1146,294,1117,110959,130446,9240,8.0,0.3968305244396340
378,1180,47,17,129,7379,8559,471,5.0,0.6373244798546750
382,502,133,3,16,2604,3106,476,3.0,0.06573192461179700
31238,85736,2033,905,7277,392274,478010,38944,13.0,0.6009913258309060
1290,4893,130,57,378,19173,24066,1612,8.0,0.724861216605353
7530,33533,694,259,1792,157188,190721,9414,9.0,0.7253052888188190
2191,6816,468,111,422,25105,31921,2742,10.0,0.30266928101373100
1416,1042,701,25,93,5122,6164,1781,6.0,0.0797672805480025
306,1538,37,21,71,5544,7082,385,6.0,0.7414380526802460
277,1027,53,14,68,4595,5622,349,9.0,0.4705211658515370
165,598,11,3,58,2523,3121,208,2.0,0.7249552124301780
42,197,7,1,6,811,1008,53,2.0,0.340139896804943
64,0,43,0,23,0,0,81,1.0,0.0014194526688868400
1737,5658,267,112,318,23191,28849,2200,9.0,0.393546799381447
13412,35405,1912,667,2280,136337,171742,17007,24.0,0.6809908835653320
2744,9303,483,66,569,40379,49682,3482,7.0,0.24137536366018300
3052,4887,1078,50,575,27516,32403,3876,6.0,0.09519693797129990
1397,4387,221,74,270,16088,20475,1775,9.0,0.3461848402778380
229,1173,51,10,42,5749,6922,291,5.0,0.43798310420450000
81,0,51,0,0,0,0,103,2.0,0.003209272235602170
1336,509,711,4,159,2224,2733,1699,4.0,0.0170828492693876
6285,21610,548,226,1592,106642,128252,7995,10.0,0.6446150842095450
9302,13186,967,446,691,108481,121667,11835,10.0,0.6404212911491630
12157,46726,1819,706,4496,558604,605330,15468,35.0,0.6098565823829650
15033,49680,3247,1063,2099,247686,297366,19265,14.0,0.576712073392293
567,0,295,0,211,0,0,727,5.0,0.008587096801386770
1624,6997,217,97,364,34536,41533,2083,8.0,0.6092996917735900
2981,6287,700,95,463,40549,46836,3829,11.0,0.25415415299756900
255,241,76,3,14,1593,1834,328,3.0,0.0793456283090306
9066,11980,2462,139,1350,71737,83717,11725,7.0,0.07582788984050760
8588,22923,2092,495,1479,140593,163516,11120,31.0,0.3939466224735530
61,359,9,2,24,1769,2128,79,2.0,0.5844495295518000
27,0,18,0,0,0,0,35,1.0,0.0013858674048462200
1261,3274,299,48,316,16540,19814,1636,6.0,0.16710323911966900
130,475,9,4,37,2543,3018,169,3.0,0.9041804312142340
344,925,42,17,87,3154,4079,448,7.0,0.6062677998820840
2370,7328,322,79,596,40953,48281,3090,9.0,0.3813242666983820
5511,20204,366,167,1552,115533,135737,7188,8.0,0.7419357070533250
4278,3660,1927,59,513,23067,26727,5595,5.0,0.054640855832203400
784,67,524,1,118,310,377,1026,2.0,0.006051874805824760
10542,34920,1418,467,2487,143159,178079,13811,19.0,0.5328803445226270
77,272,10,4,13,1296,1568,101,4.0,0.42871978416655400
9492,16646,1003,463,1040,96260,112906,12456,9.0,0.68017679823626
35,83,7,4,8,306,389,46,3.0,0.6254178577652740
89,0,59,0,0,0,0,117,1.0,0.0013665644083874500
1095,3138,189,39,169,12694,15832,1440,6.0,0.35028719479880700
424,77,305,2,115,654,731,558,2.0,0.011040233661767700
997,3520,100,52,173,14699,18219,1319,15.0,0.7118356838866750
105,186,13,4,33,1223,1409,139,3.0,0.4704909484765010
533,2213,42,16,102,12093,14306,706,7.0,0.8170333470833950
3861,15764,586,179,739,76799,92563,5115,10.0,0.5497676732538340
1263,3167,138,46,312,13038,16205,1675,9.0,0.5628295283345980
141,185,58,0,8,682,867,187,1.0,0.03996062970951660
2732,5634,153,78,403,35582,41216,3625,7.0,0.5947420356591960
5010,13895,458,152,1167,65429,79324,6649,10.0,0.5820043020850290
5682,28963,711,173,1683,106422,135385,7557,19.0,0.6334369625842010
871,2132,167,26,126,8671,10803,1159,7.0,0.19619338980420900
436,544,218,8,49,2130,2674,582,4.0,0.036085751614448800
8718,22588,994,301,1776,158071,180659,11661,9.0,0.37361007021181500
4559,12761,658,207,830,43777,56538,6101,13.0,0.5453429013938420
220,710,53,8,33,2968,3678,295,5.0,0.18817521636424100
2750,10051,258,127,809,43844,53895,3690,9.0,0.657368611526851
292,284,183,8,16,1295,1579,392,8.0,0.06295110455361340
259,775,49,5,43,4138,4913,348,3.0,0.2552660846584170
597,1616,57,19,115,7236,8852,803,4.0,0.5347811136737940
92,381,7,4,19,1625,2006,124,4.0,0.6694749576299640
534,2439,86,37,144,12155,14594,721,12.0,0.6340894384135330
90,117,27,2,5,377,494,122,2.0,0.0528381075492428
2197,23055,601,136,1438,94502,117557,2979,16.0,0.5162182475327330
725,2143,176,48,120,7667,9810,985,11.0,0.23762668430210600
467,387,186,2,181,1845,2232,635,2.0,0.03271929438563160
1954,6063,537,44,468,28533,34596,2658,7.0,0.13928478230267800
11,0,8,0,0,0,0,15,1.0,0.0013174295083106000
16432,51185,2321,899,2944,282650,333835,22415,11.0,0.5567813975062660
989,2471,144,37,209,17066,19537,1350,6.0,0.26179786193354200
3586,10674,801,220,555,47004,57678,4898,11.0,0.37452596717909900
4339,13947,576,174,986,124249,138196,5929,9.0,0.42759798363755300
363,767,33,9,49,6360,7127,497,5.0,0.7939474024026980
1531,0,714,0,392,0,0,2097,2.0,0.0032832192496435300
159,0,101,1,0,0,0,218,2.0,0.003106782264177000
196,120,135,4,4,491,611,269,4.0,0.02322088359525580
75,304,6,3,28,1873,2177,103,3.0,0.5929537428203430
136,464,23,6,25,2850,3314,187,4.0,0.34193757441266800
20838,55669,2958,1114,3874,239762,295431,28757,10.0,0.5839211960260880
63,0,43,0,0,0,0,87,1.0,0.001300910016043380
1832,5380,314,52,329,33591,38971,2530,6.0,0.26907012500563700
26,0,18,0,3,0,0,36,1.0,0.0012974684551543800
52,99,23,2,6,747,846,72,2.0,0.13450365126975300
9167,16295,1627,322,1333,164790,181085,12695,9.0,0.3421626370278870
6840,22515,1399,156,1306,112017,134532,9477,8.0,0.2076705910005140
341,1114,38,19,89,4673,5787,473,6.0,0.8042526739915970
2307,4658,378,80,462,36388,41046,3218,8.0,0.3287081203264260
1820,4026,356,159,262,22911,26937,2540,11.0,0.6999824258248440
1041,4335,99,34,281,18216,22551,1456,6.0,0.6097953352425580
5,0,3,0,0,0,0,7,1.0,0.001283210560042790
4455,11295,719,140,951,73169,84464,6243,12.0,0.3567435812479300
1848,1126,840,17,255,4332,5458,2606,4.0,0.0342969493493102
963,3791,82,41,327,21163,24954,1362,6.0,0.7883890625719100
1641,5999,230,77,419,24566,30565,2332,10.0,0.38759803155915000
441,1588,69,15,108,14740,16328,627,3.0,0.4211851064363200
8155,24908,1718,202,1997,150414,175322,11606,8.0,0.1967355860468020
1148,6530,165,57,299,68199,74729,1637,7.0,0.7144007755735380
5814,2584,2634,63,304,17790,20374,8299,6.0,0.039203752834346300
801,3773,133,48,281,22442,26215,1144,6.0,0.639742912659912
741,1934,191,16,190,9882,11816,1061,5.0,0.1879923058244380
74,287,13,4,12,1509,1796,106,3.0,0.5858059210878430
3452,16134,378,129,811,104881,121015,4947,10.0,0.6546130767834430
603,2483,92,35,94,9874,12357,868,6.0,0.48288046651393900
704,2583,135,53,169,14711,17294,1015,6.0,0.5014301116910330
2285,445,1154,18,781,4126,4571,3299,4.0,0.03238625490290900
162,706,26,12,33,5766,6472,234,3.0,0.8400685994077070
29,0,20,0,0,0,0,42,1.0,0.0012404368747080300
859,275,559,3,190,1113,1388,1247,5.0,0.021003463162678200
42,0,35,0,0,0,0,61,1.0,0.0012369308349264900
317,496,127,9,49,3271,3767,461,3.0,0.14728045772784500
206,713,44,18,54,3114,3827,300,8.0,0.5763079052333960
35,17,10,1,11,63,80,51,2.0,0.0964471121324712
896,0,620,0,163,26,26,1313,6.0,0.010328953006290900
1260,4786,111,34,377,25772,30558,1866,6.0,0.6335242033737220
1008,4742,129,60,226,23252,27994,1494,8.0,0.7521274157607780
37,103,13,2,3,591,694,55,2.0,0.246001694150682
10173,18724,1139,471,1614,149598,168322,15129,12.0,0.7062317255391550
838,201,573,8,187,1312,1513,1247,5.0,0.018436060106190800
3377,10459,231,81,726,54670,65129,5044,10.0,0.5571409112497850
656,1358,286,16,91,5593,6951,980,6.0,0.08440664220376270
6,0,4,0,0,0,0,9,1.0,0.001197663189373270
156,574,35,11,20,2611,3185,235,9.0,0.6651359762008910
522,1480,54,25,92,4621,6101,788,7.0,0.7089823939857170
400,1660,91,28,96,7766,9426,604,9.0,0.6607678561874380
391,1094,64,21,97,7482,8576,591,8.0,0.40881321042970400
25,29,12,0,3,159,188,38,1.0,0.03950712652314200
1900,614,1243,18,343,3513,4127,2897,8.0,0.023974783151228000
17342,39770,3899,972,3052,289101,328871,26501,40.0,0.4301891608046150
147,0,121,0,0,0,0,225,1.0,0.0011737099255858100
2438,4432,316,98,576,36412,40844,3736,8.0,0.5671909932268420
119,401,19,5,31,2723,3124,183,4.0,0.34165125021308900
10451,7433,4356,123,1453,42802,50235,16107,14.0,0.0580579534776277
966,2438,137,57,146,15022,17460,1492,8.0,0.7007077245191680
1213,4132,246,48,302,23006,27138,1874,8.0,0.4584627706660680
4509,14213,660,194,885,79496,93709,6971,8.0,0.5063319914770810
144,544,19,6,38,5949,6493,223,5.0,0.6758100464451730
305,1349,43,20,97,6390,7739,473,6.0,0.6552078545415960
19627,29485,2024,582,2499,281577,311062,30527,11.0,0.4835039450696980
50,621,55,11,54,1474,2095,78,13.0,0.1869940851003200
989,3323,149,43,240,18701,22024,1549,6.0,0.4711703401576970
93,317,33,2,31,1912,2229,146,2.0,0.15393350199043000
386,182,184,11,17,1166,1348,607,9.0,0.06966697652351040
54,151,16,3,10,595,746,85,3.0,0.2210322641376300
398,1024,119,19,81,3677,4701,627,11.0,0.21882721744853300
533,2315,95,20,174,15924,18239,840,8.0,0.274982455219135
45,0,31,0,0,0,0,71,1.0,0.001138623454685860
5697,15341,726,267,1302,56456,71797,9003,11.0,0.5879878058221540
773,573,451,12,85,2771,3344,1224,4.0,0.03192193060585440
6911,13902,2268,253,1282,102152,116054,10988,7.0,0.2229599566230600
2110,3235,547,201,275,32685,35920,3386,7.0,0.7204281224992230
606,2616,77,32,142,8843,11459,978,7.0,0.6076937965422490
2974,11425,769,258,531,61362,72787,4800,11.0,0.5254101523266680
137,110,97,3,2,580,690,222,4.0,0.04130197737655820
24,19,15,0,4,187,206,39,1.0,0.05658129418349920
3843,17850,977,334,1251,100520,118370,6256,12.0,0.604373872921155
22038,34815,1890,1000,4146,300818,335633,35976,18.0,0.828906654060757
188,503,34,8,61,3014,3517,307,7.0,0.323581514968822
1081,2412,585,26,227,13905,16317,1771,5.0,0.06744341732508280
238,1078,15,4,87,5197,6275,394,3.0,0.6735491198500320
872,89,431,3,311,600,689,1450,4.0,0.016210112073117500
3309,12718,458,201,794,68553,81271,5523,8.0,0.6649211675322220
82,346,11,5,22,1838,2184,137,4.0,0.8088119927051770
724,2456,123,59,104,8456,10912,1210,9.0,0.7226407088873950
306,1199,25,14,117,7642,8841,513,5.0,0.7194970435046600
903,2552,73,28,301,12157,14709,1518,7.0,0.583989387117107
843,3471,152,35,184,23452,26923,1420,4.0,0.7201466412808370
75,251,13,3,12,949,1200,127,3.0,0.39070682158851800
72,324,10,4,14,1490,1814,122,5.0,0.6904830647607680
23,77,2,0,4,519,596,39,1.0,0.7110342099433830
10,16,4,1,1,25,41,17,2.0,0.13507527252855200
27,0,22,0,0,0,0,46,1.0,0.0010544643297742900
24,55,11,1,2,151,206,41,2.0,0.10423573439096000
14,47,8,0,3,398,445,24,1.0,0.1422524453178110
30,133,5,1,10,933,1066,52,2.0,0.5006775686412380
19,88,5,1,7,1071,1159,33,2.0,0.5391923229947180
145,6,110,3,3,86,92,252,4.0,0.00992471339961016
1618,3982,623,47,402,26054,30036,2821,7.0,0.1544216310649150
195,796,51,10,44,3672,4468,341,5.0,0.27479903599976000
1495,31,1349,0,101,98,129,2624,3.0,0.005573236086587100
1898,5111,550,150,488,39978,45089,3332,8.0,0.4456668981223760
279,470,35,14,64,1304,1774,491,4.0,0.6564745072137950
106,479,7,5,37,2148,2627,187,4.0,0.9502348494166210
43,103,13,2,4,373,476,76,3.0,0.15009786653402900
222,726,39,11,50,6187,6913,393,4.0,0.7952774026585460
111,325,37,2,21,1581,1906,197,2.0,0.1314960241962690
187,433,75,6,32,2544,2977,332,4.0,0.1881970562917780
245,308,175,10,23,1558,1866,438,3.0,0.18877247032796500
43,0,39,1,0,0,0,77,2.0,0.002799732131002460
24,0,22,1,0,0,0,43,2.0,0.002799189547256140
270,748,58,18,53,6194,6942,485,4.0,0.7696644753111760
89,182,52,3,14,1567,1749,162,2.0,0.11657067375212100
414,904,41,16,53,5295,6199,760,6.0,0.6242396195156480
344,1194,48,13,72,7068,8262,634,4.0,0.6192084926221750
25,0,21,1,0,0,0,47,2.0,0.002752077116006670
1444,4198,220,72,297,51279,55477,2737,7.0,0.7793787926010910
640,1475,105,26,152,13413,14888,1224,5.0,0.6329633181843500
629,2123,115,34,132,6449,8572,1203,8.0,0.5675350232566190
410,1508,191,6,96,7682,9190,787,4.0,0.09780930680342700
150,719,17,13,54,3767,4486,288,11.0,0.7568584090336000
148,418,30,12,43,953,1371,286,10.0,0.5582981497140330
608,1265,100,38,79,5052,6317,1184,5.0,0.9419264922391520
1101,3641,167,74,280,30710,34351,2153,6.0,1.0
48,177,8,4,22,719,896,94,4.0,0.7240065096227830
24,11,22,0,1,36,47,47,1.0,0.016334550640055700
48,196,12,3,19,2552,2748,94,2.0,0.6245405817453320
449,727,153,11,60,3310,4037,884,5.0,0.14388997424868100
73,56,63,2,5,299,355,144,2.0,0.04983811591517310
47,74,30,3,2,803,877,93,4.0,0.1797669266671420
79,292,12,3,21,1359,1651,157,4.0,0.6499176510343750
134,321,78,2,25,1808,2129,269,3.0,0.06901430527644020
102,196,34,8,21,1841,2037,206,5.0,0.35122714466800000
47,83,19,2,13,1008,1091,95,2.0,0.19602594664805300
294,1302,45,11,58,8655,9957,596,4.0,0.6680245089672820
72,142,12,3,10,982,1124,146,3.0,0.38868928335230100
85,146,36,2,33,1419,1565,173,2.0,0.1372166639046500
485,1,474,0,182,8,9,989,4.0,0.006334148454869750
114,13,57,0,60,66,79,233,1.0,0.011292337953999100
18,64,5,1,2,482,546,37,2.0,0.35018441624809700
731,2914,124,51,182,17967,20881,1512,7.0,0.7878143908846270
2467,6651,409,158,517,62265,68916,5104,6.0,0.6234771986130000
82,191,32,5,14,1246,1437,170,3.0,0.13304364828010700
41,0,43,0,0,4,4,85,2.0,0.003799426725248450
80,22,65,0,9,205,227,166,2.0,0.02574585145898910
11,0,5,0,0,0,0,23,1.0,8.5919315759387E-04
192,0,189,0,128,0,0,402,1.0,8.58027359551001E-04
21,46,14,0,2,401,447,44,1.0,0.12219780852276600
265,1211,54,19,64,7832,9043,568,5.0,0.646804448249226
110,120,27,8,7,2160,2280,237,6.0,0.5186900718607330
24,94,4,1,9,729,823,52,2.0,0.7488895795213430
715,1982,195,63,194,17852,19834,1550,6.0,0.5516045255111760
16,69,3,1,8,497,566,35,2.0,0.5554590777571900
5,0,6,0,0,0,0,11,1.0,8.16588538209049E-04
4,0,5,0,0,0,0,9,1.0,7.98442126248849E-04
16,58,3,0,5,644,702,36,1.0,0.7663447527736450
349,996,44,15,138,4844,5840,786,5.0,0.6156235224423490
153,283,61,15,37,3090,3373,352,6.0,0.40897392846223900
33,92,19,4,6,596,688,76,5.0,0.23065574741973400
16,100,6,1,8,774,874,37,2.0,0.561642534192827
128,595,18,8,46,3932,4527,298,5.0,0.7406879671611160
6,29,1,0,1,96,125,14,1.0,0.5425927532084940
43,149,24,6,14,1369,1518,101,4.0,0.3288646750428140
14,0,14,0,0,0,0,33,1.0,7.62149302328446E-04
181,561,47,8,49,3011,3572,432,3.0,0.30936756797162500
43,46,37,1,14,304,350,103,2.0,0.04725493091871300
295,507,231,18,48,2402,2909,709,10.0,0.09752955727392120
49,0,57,0,2,0,0,118,1.0,7.46002071346911E-04
150,544,26,10,33,2366,2910,362,4.0,0.6261733342005350
164,21,112,4,3,171,192,402,3.0,0.036457480361207800
148,165,124,3,11,710,875,363,4.0,0.030670171478355000
139,423,72,13,34,3930,4353,347,5.0,0.3473233603619290
825,4070,201,76,293,28128,32198,2072,5.0,0.6310222015099730
173,937,55,11,98,13197,14134,435,5.0,0.5242195808239200
183,845,46,25,65,4469,5314,463,13.0,0.6192041616852610
28,161,14,1,11,617,778,71,3.0,0.3500497196822990
13,75,6,1,7,469,544,33,2.0,0.23676712469192000
42,197,14,1,12,1459,1656,108,2.0,0.4076816980836400
411,1029,93,39,86,11138,12167,1063,5.0,0.7294610600272550
39,52,25,1,6,308,360,105,2.0,0.11387518480354100
222,0,294,0,0,0,0,599,1.0,6.6581275803222E-04
126,337,29,16,36,2162,2499,340,7.0,0.6186847447867500
87,441,22,14,35,3502,3943,236,7.0,0.8270498678125300
7,0,10,0,0,0,0,19,1.0,6.61866499390493E-04
18,25,14,2,3,281,306,49,3.0,0.18790602178089500
599,1966,96,30,148,13286,15252,1652,5.0,0.5929257812040260
1681,5018,319,145,560,16224,21242,4641,10.0,0.7509018399691160
26,115,14,0,3,493,608,72,1.0,0.2043199143175690
31,121,8,2,8,1076,1197,86,3.0,0.7609241663153850
19,0,23,0,9,78,78,53,1.0,0.017577942483507900
9,35,4,0,8,225,260,26,1.0,0.8115596091037410
59,26,88,1,1,358,384,172,2.0,0.013942964433452700
5,0,8,0,0,0,0,15,1.0,5.98831594686636E-04
2,2,3,0,1,52,54,6,1.0,0.07485394933582960
1,3,1,0,0,26,29,3,1.0,0.33115387186171000
151,636,71,19,51,3627,4263,457,11.0,0.45186295883876500
30,0,47,0,0,0,0,91,1.0,5.92251027712058E-04
14,38,3,1,4,277,315,44,2.0,0.8182162713618800
19,36,17,1,2,237,273,60,2.0,0.06450296909473140
289,665,46,13,47,4468,5133,916,4.0,0.6995907293514470
76,416,23,9,25,2525,2941,246,4.0,0.6764900825747180
13,82,3,0,9,506,588,43,1.0,0.6285977028374090
28,0,36,0,9,0,0,93,4.0,0.00593036450221927
107,39,178,1,1,454,493,362,3.0,0.015120968013504900
23,17,30,0,1,238,255,79,1.0,0.02232050017359840
16,5,14,0,1,46,51,55,1.0,0.05585465601349900
105,89,157,3,16,444,533,367,2.0,0.01660920366946940
8,38,4,3,1,220,258,28,4.0,0.5915600681797270
4,24,2,1,3,225,249,14,2.0,0.7704909486720940
30,127,7,1,10,1955,2082,108,2.0,0.697077046742535
3,0,5,0,0,0,0,11,1.0,4.8995312292543E-04
47,210,12,5,35,2069,2279,173,2.0,0.774777316986762
11,28,3,1,3,291,319,41,2.0,0.99346453671486
35,148,10,4,18,1818,1966,132,3.0,0.6538255663808630
5,0,11,0,3,0,0,19,1.0,4.72761785278923E-04
38,234,24,6,32,2511,2745,146,16.0,0.47564045121805300
21,87,7,2,6,721,808,81,2.0,0.7376958888627630
8,69,3,1,9,487,556,31,2.0,0.5431248026622070
34,135,22,4,16,1430,1565,134,3.0,0.3802674879265550
4,10,2,1,0,148,158,17,2.0,0.6805756299001550
18,0,19,0,0,0,0,77,1.0,4.19959819650368E-04
5,17,1,0,2,165,182,22,1.0,0.782242824291977
2,0,5,0,0,0,0,9,1.0,3.99221063124424E-04
14,0,31,0,0,0,0,69,1.0,3.64506188070126E-04
13,14,11,0,5,123,137,66,1.0,0.26623508307409100
35,164,17,3,11,1669,1833,180,2.0,0.6534491457506490
59,133,67,3,10,1850,1983,305,3.0,0.1810588059265810
9,2,9,0,3,10,12,47,1.0,0.03148325256320590
7,34,13,5,2,732,766,38,4.0,0.5673323254802960
6,0,10,0,0,0,0,35,1.0,3.0797053441027E-04
3,15,3,0,0,161,176,18,1.0,0.16461880537935600
1,0,4,0,0,0,0,6,1.0,2.99415797343318E-04
5,40,2,0,9,346,386,30,1.0,0.7900385228700790
1,0,3,0,0,0,0,6,1.0,2.99415797343318E-04
1,5,1,0,0,49,54,6,1.0,0.09659153622295450
1,0,3,0,0,0,0,6,1.0,2.99415797343318E-04
6,0,16,0,0,0,0,36,1.0,2.99415797343318E-04
2,0,7,0,0,0,0,13,1.0,2.76383812932294E-04
2,7,3,0,0,202,209,14,1.0,0.3926111029506930
6,0,25,0,0,0,0,42,1.0,2.56642112008559E-04
3,33,4,1,6,623,656,22,2.0,0.45080586840368800
113,400,100,30,69,11685,12085,838,5.0,0.6584204491498010
5,4,18,0,6,45,49,39,1.0,0.029932366940567400
5,12,4,1,1,157,169,41,2.0,0.4892249649508710
1,0,5,0,0,0,0,9,1.0,1.99610531562212E-04
4,14,11,5,0,293,307,36,6.0,0.4758787658090980
1,0,12,0,0,0,0,21,1.0,8.55473706695195E-05
1,12,4,0,0,222,234,41,1.0,0.6679805776594270
65,197,3,2,9,578,775,26,2.0,0.5485896238924280
2730,5863,69,38,539,26327,32190,1120,8.0,0.4944575258964310
57,68,10,1,3,216,284,25,2.0,0.08608803005215080
2,0,1,0,0,0,0,1,1.0,0.0035929895681198200
3,0,1,0,0,0,0,2,1.0,0.002694742176089860
3,0,1,0,0,0,0,2,1.0,0.002694742176089860
3,0,1,0,0,0,0,2,1.0,0.002694742176089860
1977,9133,130,54,348,41830,50963,1875,7.0,0.7443606438091090
52,290,6,2,18,1259,1549,50,3.0,0.4308713090089290
726,3501,62,30,128,12571,16072,699,8.0,0.7034608470501610
11218,40567,457,195,3227,174588,215155,11003,8.0,0.6054562045973100
15010,48571,1174,457,3221,168685,217256,14825,13.0,0.6747044507575050
16,0,8,0,0,0,0,16,1.0,0.001796494784059910
4,0,3,0,0,0,0,4,1.0,0.001796494784059910
2094,52,1035,1,149,215,267,2101,8.0,0.015725407313776000
15605,37743,941,406,1976,161683,199426,15711,18.0,0.6081103366247500
2334,8460,238,101,514,31863,40323,2368,8.0,0.6358367410842030
27520,98933,1548,787,7256,399097,498030,27977,13.0,0.7509407542723320
8376,21631,1035,180,1524,87000,108631,8552,7.0,0.28838844322135600
6518,24626,443,191,873,100829,125455,6677,21.0,0.7145996007726820
5440,9221,969,88,518,58967,68188,5576,6.0,0.1698574988441900
6373,9673,1196,399,488,65225,74898,6536,16.0,0.6016511700107460
1436,4148,208,70,206,16173,20321,1476,9.0,0.3349146765877950
3402,11133,488,270,640,54253,65386,3500,11.0,0.3625589174781650
681,1259,209,42,120,4444,5703,701,10.0,0.1744305071096100
813,2745,100,24,162,12454,15199,837,5.0,0.3430215035273360
4795,11082,276,149,750,61601,72683,4960,10.0,0.5178514585078340
29191,101157,3044,1130,7082,367405,468562,30210,14.0,0.5132562724010310
4442,14406,521,170,869,65752,80158,4645,25.0,0.3800121995657050
306,1175,19,9,84,8131,9306,320,3.0,0.7097637687137950
19082,29475,1274,617,1666,207744,237219,20027,16.0,0.7719691573984200
820,1165,157,10,72,4833,5998,864,3.0,0.07515303668683610
4774,15343,710,174,856,55221,70564,5033,10.0,0.3815781821777310
27777,78610,3104,1326,3905,317914,396524,29303,18.0,0.706626657111241
2716,2269,771,32,437,15030,17299,2866,5.0,0.07842934114826480
15786,23628,1406,520,1346,147891,171519,16740,15.0,0.6653494416663010
18991,57849,1080,436,4148,188196,246045,20156,8.0,0.5699918266609020
1172,3775,211,35,221,19125,22900,1257,8.0,0.24478077442535800
1766,6090,123,37,290,23058,29148,1905,6.0,0.6644551420919220
4046,16204,469,171,749,74699,90903,4397,11.0,0.5951460137427630
9950,27603,1122,205,2192,139366,166969,10884,8.0,0.29844184202365400
6245,28065,464,196,1522,163259,191324,6880,7.0,0.7751951437882620
12131,32107,1883,274,2014,172202,204309,13553,9.0,0.26349439244487000
3468,3636,1443,38,555,23134,26770,3933,9.0,0.049182865025113300
28,105,3,2,2,602,707,32,3.0,0.7711902984273180
28,58,14,0,3,192,250,32,1.0,0.03267695691148970
4716,6310,1617,58,750,34739,41049,5429,7.0,0.06616726553895570
11738,46056,2039,958,4154,177040,223096,13620,54.0,0.5445155890427820
273,1034,31,12,64,4173,5207,320,8.0,0.5380355188665170
83,379,10,2,16,1630,2009,100,3.0,0.574788506159968
26,56,12,1,2,200,256,32,2.0,0.18218702728847600
6455,21079,703,202,2543,87750,108829,8000,20.0,0.38996313749582000
544,245,278,4,28,1949,2194,709,3.0,0.048035577360158700
1445,1406,637,28,120,7274,8680,1885,7.0,0.08866367434129780
21,108,3,2,13,692,800,28,3.0,0.6497622218147350
663,1961,48,19,139,7252,9213,895,6.0,0.6465119713354760
2180,7816,349,111,392,35282,43098,3011,7.0,0.7474832857185500
620,725,225,21,134,5989,6714,929,7.0,0.13696924530102900
35,64,8,2,4,390,454,53,2.0,0.3696474446898460
16,17,10,0,1,120,137,25,1.0,0.05705667434174270
162,568,8,4,68,4836,5404,256,3.0,0.6406889874808660
132,549,21,6,31,3153,3702,209,5.0,0.4867699421007360
3387,13965,596,341,1025,69172,83137,5366,44.0,0.6798231450713320
649,3216,107,44,167,14175,17391,1029,14.0,0.7155100565608300
6224,13035,2134,201,1242,134203,147238,10215,9.0,0.1752465056629360
821,3255,94,47,192,13211,16466,1376,11.0,0.6417095758014730
1487,5655,162,51,390,24109,29764,2493,5.0,0.7102744667240110
1384,5,1070,0,237,38,43,2385,3.0,0.0049685908861308200
34,134,11,6,7,779,913,59,4.0,0.7941387200300100
5488,15569,616,250,842,84398,99967,9942,9.0,0.6783098644738030
1480,986,609,81,247,15116,16102,2701,6.0,0.37117499275561200
201,605,58,11,54,3956,4561,367,5.0,0.3365939162135710
1770,5185,872,44,548,34090,39275,3529,5.0,0.08611423379322260
1,0,1,0,0,0,0,2,1.0,8.98247392029954E-04
1,0,1,0,0,0,0,2,1.0,8.98247392029954E-04
1,0,1,0,0,0,0,2,1.0,8.98247392029954E-04
18,82,7,0,3,676,758,36,1.0,0.3300160918318050
1,0,1,0,0,0,0,2,1.0,8.98247392029954E-04
623,1228,484,17,165,4950,6178,1280,5.0,0.06896896354371530
81,0,80,0,0,0,0,180,1.0,8.08422652826959E-04
7,27,3,1,3,159,186,16,2.0,0.41984831642973400
333,26,338,0,49,109,135,768,3.0,0.0061067784118785
2,0,3,0,0,0,0,5,1.0,7.18597913623964E-04
2,0,2,0,0,0,0,5,1.0,7.18597913623964E-04
2,0,3,0,0,0,0,5,1.0,7.18597913623964E-04
3,0,4,1,0,0,0,8,2.0,0.002470180328082380
3,0,4,0,0,0,0,8,1.0,6.73685544022466E-04
25,56,24,1,6,344,400,67,2.0,0.07282954103374540
224,37,248,2,55,533,570,625,2.0,0.01593145482851040
8,12,10,1,1,100,112,25,2.0,0.10656807059043400
5,58,2,1,0,195,253,16,2.0,0.4371096371465770
6,15,5,0,1,119,134,20,2.0,0.24550897718962700
11,24,8,2,3,526,550,40,2.0,0.4882423699378820
8,0,11,0,0,0,0,32,1.0,4.49123696014977E-04
6,31,3,0,4,182,213,25,1.0,0.4478781262980290
12,16,13,3,1,505,521,58,4.0,0.2800444688826960
3,8,2,0,2,106,114,15,1.0,0.3697186265595290
1,2,2,0,0,8,10,5,1.0,0.15629504621321200
6,19,4,0,2,112,131,30,1.0,0.10204090373460300
92,0,316,0,32,10,10,575,5.0,0.00883784471996257
2,0,11,0,0,0,0,16,1.0,2.24561848007489E-04
1,0,6,0,0,0,0,11,1.0,1.63317707805128E-04
3,0,1,0,2,3,3,34,1.0,0.317778792067233
6,33,5,1,4,415,448,70,2.0,0.7593526810114360
1,1,3,0,0,17,18,16,1.0,0.053288526532177100
1,5,1,0,1,94,99,16,1.0,0.47869849139756400
1,0,7,0,0,0,0,18,1.0,9.98052665795482E-05
1,0,8,1,0,40,40,19,2.0,0.23238132793609700
1,4,3,2,1,435,439,20,3.0,0.9440879506032170
4,0,48,0,0,2,2,110,1.0,0.011622776859855500
0,0,2,0,0,0,0,5,1.0,0.0
0,0,1,0,0,0,0,2,1.0,0.0
0,0,1,0,0,0,0,2,1.0,0.0
0,0,1,0,0,0,0,1,1.0,0.0
0,0,2,0,0,0,0,4,1.0,0.0
0,0,7,0,0,0,0,13,1.0,0.0
0,0,1,0,0,0,0,1,1.0,0.0
0,0,2,0,0,0,0,4,1.0,0.0
0,0,1,0,0,6,6,1,1.0,0.1509055618610320
0,0,2,0,0,0,0,4,1.0,0.0
0,0,1,0,0,0,0,1,1.0,0.11210127452533800
0,0,1,0,0,0,0,2,1.0,0.0
0,0,1,0,0,0,0,1,1.0,0.06467381222615670
0,1,1,0,0,32,33,15,1.0,0.6237429890256000
0,0,1,0,0,0,0,2,1.0,0.0
0,0,5,0,0,0,0,9,1.0,0.0